# # # # # # # # # # # 
# # # # # # # # # # # 
# # # # # # # # # # # 
# # # # # # # # # # # 
# # # # # # # # # # # 
# # # # # # # # # # # 
# # # # # # = = # # # 
# # # # # # # = # # # 
# # # # # # + = # # # 
# # # # # = = = # # # 
# # # # # # # # # # # 
